1111111
10P0001
1000001
1000001
1C00101
100C1E1
1111111
